{
    "circle": [
        "0000000020.jpg",
        "0000000030.jpg",
        "0000000040.jpg",
        "0000000050.jpg",
        "0000000060.jpg",
        "0000000070.jpg",
        "0000000080.jpg",
        "0000000090.jpg",
        "0000000100.jpg",
        "0000000110.jpg"
    ],
    "nextTo": [
        "0000000020.jpg",
        "0000000030.jpg",
        "0000000040.jpg",
        "0000000050.jpg",
        "0000000060.jpg",
        "0000000070.jpg",
        "0000000080.jpg",
        "0000000090.jpg",
        "0000000100.jpg",
        "0000000110.jpg"
    ],
    "line": [
        "0000000020.jpg",
        "0000000030.jpg",
        "0000000040.jpg",
        "0000000050.jpg",
        "0000000060.jpg",
        "0000000070.jpg",
        "0000000080.jpg",
        "0000000090.jpg",
        "0000000100.jpg",
        "0000000110.jpg",
        "0000000120.jpg",
        "0000000130.jpg",
        "0000000140.jpg",
        "0000000150.jpg",
        "0000000180.jpg",
        "0000000190.jpg",
        "0000000220.jpg",
        "0000000230.jpg",
        "0000000240.jpg",
        "0000000250.jpg",
        "0000000260.jpg",
        "0000000280.jpg",
        "0000000290.jpg",
        "0000000300.jpg",
        "0000000320.jpg",
        "0000000330.jpg",
        "0000000340.jpg",
        "0000000350.jpg",
        "0000000900.jpg",
        "0000000910.jpg",
        "0000000920.jpg",
        "0000001460.jpg",
        "0000001470.jpg"
    ],
    "center": [
        "0000000020.jpg",
        "0000000030.jpg",
        "0000000040.jpg",
        "0000000050.jpg",
        "0000000060.jpg",
        "0000000070.jpg",
        "0000000080.jpg",
        "0000000090.jpg",
        "0000000100.jpg",
        "0000000110.jpg",
        "0000000180.jpg",
        "0000000190.jpg",
        "0000001100.jpg",
        "0000001110.jpg",
        "0000001270.jpg",
        "0000001300.jpg",
        "0000001460.jpg",
        "0000001470.jpg",
        "0000001500.jpg",
        "0000001510.jpg",
        "0000001540.jpg",
        "0000001550.jpg",
        "0000001560.jpg",
        "0000001570.jpg",
        "0000001590.jpg"
    ],
    "around": [
        "0000000020.jpg",
        "0000000030.jpg",
        "0000000040.jpg",
        "0000000050.jpg",
        "0000000060.jpg",
        "0000000070.jpg",
        "0000000080.jpg"
    ],
    "cluster": [
        "0000000020.jpg",
        "0000000030.jpg",
        "0000000040.jpg",
        "0000000050.jpg",
        "0000000060.jpg",
        "0000000070.jpg",
        "0000000080.jpg",
        "0000000180.jpg",
        "0000000190.jpg",
        "0000000220.jpg",
        "0000000230.jpg",
        "0000000240.jpg",
        "0000000250.jpg",
        "0000000260.jpg",
        "0000000280.jpg",
        "0000000290.jpg",
        "0000000300.jpg",
        "0000000320.jpg",
        "0000000330.jpg",
        "0000000340.jpg",
        "0000000350.jpg",
        "0000000380.jpg",
        "0000000390.jpg",
        "0000000420.jpg",
        "0000000430.jpg",
        "0000000440.jpg",
        "0000000450.jpg",
        "0000000460.jpg",
        "0000000470.jpg",
        "0000000480.jpg",
        "0000000490.jpg",
        "0000000500.jpg",
        "0000000510.jpg",
        "0000000520.jpg",
        "0000000530.jpg",
        "0000000540.jpg",
        "0000000550.jpg",
        "0000000580.jpg",
        "0000000590.jpg",
        "0000000620.jpg",
        "0000000630.jpg",
        "0000000640.jpg",
        "0000000650.jpg",
        "0000000710.jpg",
        "0000000720.jpg",
        "0000000730.jpg",
        "0000000840.jpg",
        "0000000860.jpg",
        "0000000870.jpg",
        "0000000880.jpg",
        "0000000890.jpg",
        "0000000900.jpg",
        "0000000910.jpg",
        "0000000920.jpg",
        "0000000960.jpg",
        "0000000970.jpg",
        "0000001000.jpg",
        "0000001010.jpg",
        "0000001020.jpg",
        "0000001030.jpg",
        "0000001060.jpg",
        "0000001070.jpg",
        "0000001100.jpg",
        "0000001110.jpg",
        "0000001140.jpg",
        "0000001150.jpg",
        "0000001160.jpg",
        "0000001170.jpg",
        "0000001180.jpg",
        "0000001200.jpg",
        "0000001210.jpg",
        "0000001220.jpg",
        "0000001260.jpg",
        "0000001270.jpg",
        "0000001340.jpg",
        "0000001360.jpg",
        "0000001370.jpg",
        "0000001380.jpg",
        "0000001400.jpg",
        "0000001410.jpg",
        "0000001420.jpg",
        "0000001430.jpg",
        "0000001460.jpg",
        "0000001470.jpg",
        "0000001500.jpg",
        "0000001510.jpg",
        "0000001540.jpg",
        "0000001550.jpg",
        "0000001560.jpg",
        "0000001570.jpg"
    ],
    "along": [
        "0000000120.jpg",
        "0000000130.jpg",
        "0000000140.jpg",
        "0000000150.jpg",
        "0000000180.jpg",
        "0000000190.jpg",
        "0000000220.jpg",
        "0000000230.jpg",
        "0000000240.jpg",
        "0000000250.jpg",
        "0000000260.jpg",
        "0000000280.jpg",
        "0000000290.jpg",
        "0000000300.jpg",
        "0000000320.jpg",
        "0000000330.jpg",
        "0000000340.jpg",
        "0000000350.jpg",
        "0000000380.jpg",
        "0000000390.jpg",
        "0000000420.jpg",
        "0000000440.jpg",
        "0000000450.jpg",
        "0000000460.jpg",
        "0000000470.jpg",
        "0000000480.jpg",
        "0000000490.jpg",
        "0000000500.jpg",
        "0000000510.jpg",
        "0000001460.jpg",
        "0000001470.jpg"
    ],
    "left": [
        "0000000220.jpg",
        "0000000230.jpg",
        "0000000240.jpg",
        "0000000250.jpg",
        "0000000260.jpg"
    ],
    "leftOf": [
        "0000000430.jpg",
        "0000000440.jpg",
        "0000000450.jpg",
        "0000000460.jpg",
        "0000000470.jpg",
        "0000000480.jpg",
        "0000000490.jpg",
        "0000000500.jpg",
        "0000000510.jpg",
        "0000000520.jpg",
        "0000000530.jpg",
        "0000000540.jpg",
        "0000000550.jpg",
        "0000000580.jpg",
        "0000000590.jpg",
        "0000000620.jpg",
        "0000000630.jpg",
        "0000000640.jpg",
        "0000000650.jpg",
        "0000000670.jpg",
        "0000000680.jpg",
        "0000000690.jpg",
        "0000000840.jpg",
        "0000000860.jpg",
        "0000000870.jpg",
        "0000000880.jpg",
        "0000000890.jpg",
        "0000000900.jpg",
        "0000000910.jpg",
        "0000000920.jpg",
        "0000000960.jpg",
        "0000000970.jpg",
        "0000001000.jpg",
        "0000001010.jpg",
        "0000001020.jpg",
        "0000001030.jpg",
        "0000001060.jpg",
        "0000001070.jpg",
        "0000001140.jpg",
        "0000001150.jpg",
        "0000001160.jpg",
        "0000001170.jpg",
        "0000001180.jpg",
        "0000001200.jpg",
        "0000001210.jpg",
        "0000001220.jpg",
        "0000001260.jpg",
        "0000001270.jpg",
        "0000001500.jpg",
        "0000001510.jpg",
        "0000001540.jpg",
        "0000001550.jpg",
        "0000001560.jpg",
        "0000001570.jpg"
    ],
    "rightOf": [
        "0000000430.jpg",
        "0000000440.jpg",
        "0000000450.jpg",
        "0000000460.jpg",
        "0000000470.jpg",
        "0000000480.jpg",
        "0000000490.jpg",
        "0000000500.jpg",
        "0000000510.jpg",
        "0000000520.jpg",
        "0000000530.jpg",
        "0000000540.jpg",
        "0000000550.jpg",
        "0000000580.jpg",
        "0000000590.jpg",
        "0000000620.jpg",
        "0000000630.jpg",
        "0000000640.jpg",
        "0000000650.jpg",
        "0000000670.jpg",
        "0000000680.jpg",
        "0000000690.jpg",
        "0000000840.jpg",
        "0000000860.jpg",
        "0000000870.jpg",
        "0000000880.jpg",
        "0000000890.jpg",
        "0000000900.jpg",
        "0000000910.jpg",
        "0000000920.jpg",
        "0000000960.jpg",
        "0000000970.jpg",
        "0000001000.jpg",
        "0000001010.jpg",
        "0000001020.jpg",
        "0000001030.jpg",
        "0000001060.jpg",
        "0000001070.jpg",
        "0000001140.jpg",
        "0000001150.jpg",
        "0000001160.jpg",
        "0000001170.jpg",
        "0000001180.jpg",
        "0000001200.jpg",
        "0000001210.jpg",
        "0000001220.jpg",
        "0000001260.jpg",
        "0000001270.jpg",
        "0000001500.jpg",
        "0000001510.jpg",
        "0000001540.jpg",
        "0000001550.jpg",
        "0000001560.jpg",
        "0000001570.jpg",
        "0000001590.jpg"
    ],
    "alone": [
        "0000000430.jpg",
        "0000000440.jpg",
        "0000000450.jpg",
        "0000000710.jpg",
        "0000000720.jpg",
        "0000000740.jpg",
        "0000000750.jpg",
        "0000000780.jpg",
        "0000000790.jpg",
        "0000000800.jpg",
        "0000000810.jpg",
        "0000001100.jpg",
        "0000001300.jpg",
        "0000001510.jpg",
        "0000001590.jpg"
    ]
}